10.oxcccc
.........o
.......ooo
..........
.....o....
..........
.........o
..........
..........
..........
..........