10.ox
.........o
.......ooo
.........
.....o....
..........
.........o
..........
..........
..........
..........